"filename", "language", "TypeScript", "Svelte", "comment", "blank", "total"
"/Users/phylliphall/Documents/Programs/esp/src/lib/components/app/types.app.svelte.ts", "TypeScript", 788, 0, 32, 64, 884
"/Users/phylliphall/Documents/Programs/esp/src/lib/components/app/types.appQuery.ts", "TypeScript", 164, 0, 7, 27, 198
"/Users/phylliphall/Documents/Programs/esp/src/lib/components/app/types.appState.svelte.ts", "TypeScript", 565, 0, 2, 57, 624
"/Users/phylliphall/Documents/Programs/esp/src/lib/components/app/types.node.ts", "TypeScript", 144, 0, 0, 10, 154
"/Users/phylliphall/Documents/Programs/esp/src/lib/components/dataObj/DataObjActionsObj.svelte", "Svelte", 0, 68, 0, 9, 77
"/Users/phylliphall/Documents/Programs/esp/src/lib/components/dataObj/types.dataManager.svelte.ts", "TypeScript", 397, 0, 5, 41, 443
"/Users/phylliphall/Documents/Programs/esp/src/lib/components/dataObj/types.dataObj.svelte.ts", "TypeScript", 943, 0, 5, 82, 1030
"/Users/phylliphall/Documents/Programs/esp/src/lib/components/dataObj/types.rawDataObj.svelte.ts", "TypeScript", 960, 0, 9, 62, 1031
"/Users/phylliphall/Documents/Programs/esp/src/lib/components/dataObj/types.rep.ts", "TypeScript", 274, 0, 2, 12, 288
"/Users/phylliphall/Documents/Programs/esp/src/lib/components/form/ContentFormDetailApp.svelte", "Svelte", 0, 6, 0, 2, 8
"/Users/phylliphall/Documents/Programs/esp/src/lib/components/form/ContentFormDetailRepConfig.svelte", "Svelte", 0, 6, 0, 2, 8
"/Users/phylliphall/Documents/Programs/esp/src/lib/components/form/ContentFormListApp.svelte", "Svelte", 0, 12, 0, 4, 16
"/Users/phylliphall/Documents/Programs/esp/src/lib/components/form/FormDetail.svelte", "Svelte", 0, 41, 1, 13, 55
"/Users/phylliphall/Documents/Programs/esp/src/lib/components/form/FormDetailEl.svelte", "Svelte", 0, 27, 0, 7, 34
"/Users/phylliphall/Documents/Programs/esp/src/lib/components/form/FormDetailElField.svelte", "Svelte", 0, 20, 0, 4, 24
"/Users/phylliphall/Documents/Programs/esp/src/lib/components/form/FormDetailElGroupDetails.svelte", "Svelte", 0, 19, 0, 4, 23
"/Users/phylliphall/Documents/Programs/esp/src/lib/components/form/FormDetailElGroupRow.svelte", "Svelte", 0, 14, 0, 4, 18
"/Users/phylliphall/Documents/Programs/esp/src/lib/components/form/FormDetailElGroupSection.svelte", "Svelte", 0, 20, 0, 5, 25
"/Users/phylliphall/Documents/Programs/esp/src/lib/components/form/FormElChips.svelte", "Svelte", 0, 106, 2, 7, 115
"/Users/phylliphall/Documents/Programs/esp/src/lib/components/form/FormElCustomActionButton.svelte", "Svelte", 0, 41, 0, 6, 47
"/Users/phylliphall/Documents/Programs/esp/src/lib/components/form/FormElCustomActionLink.svelte", "Svelte", 0, 37, 0, 6, 43
"/Users/phylliphall/Documents/Programs/esp/src/lib/components/form/FormElCustomHTML.svelte", "Svelte", 0, 8, 0, 2, 10
"/Users/phylliphall/Documents/Programs/esp/src/lib/components/form/FormElCustomHeader.svelte", "Svelte", 0, 23, 0, 4, 27
"/Users/phylliphall/Documents/Programs/esp/src/lib/components/form/FormElCustomText.svelte", "Svelte", 0, 12, 0, 4, 16
"/Users/phylliphall/Documents/Programs/esp/src/lib/components/form/FormElEmbedListConfig.svelte", "Svelte", 0, 26, 1, 7, 34
"/Users/phylliphall/Documents/Programs/esp/src/lib/components/form/FormElEmbedListEdit.svelte", "Svelte", 0, 31, 1, 7, 39
"/Users/phylliphall/Documents/Programs/esp/src/lib/components/form/FormElEmbedListSelect.svelte", "Svelte", 0, 55, 0, 7, 62
"/Users/phylliphall/Documents/Programs/esp/src/lib/components/form/FormElEmbedShell.svelte", "Svelte", 0, 64, 7, 16, 87
"/Users/phylliphall/Documents/Programs/esp/src/lib/components/form/FormElFile.svelte", "Svelte", 0, 156, 3, 17, 176
"/Users/phylliphall/Documents/Programs/esp/src/lib/components/form/FormElInp.svelte", "Svelte", 0, 148, 4, 19, 171
"/Users/phylliphall/Documents/Programs/esp/src/lib/components/form/FormElInpCheckbox.svelte", "Svelte", 0, 69, 1, 9, 79
"/Users/phylliphall/Documents/Programs/esp/src/lib/components/form/FormElInpRadio.svelte", "Svelte", 0, 66, 1, 9, 76
"/Users/phylliphall/Documents/Programs/esp/src/lib/components/form/FormElSelect.svelte", "Svelte", 0, 66, 2, 9, 77
"/Users/phylliphall/Documents/Programs/esp/src/lib/components/form/FormElTextarea.svelte", "Svelte", 0, 39, 0, 8, 47
"/Users/phylliphall/Documents/Programs/esp/src/lib/components/form/FormElToggle.svelte", "Svelte", 0, 39, 0, 7, 46
"/Users/phylliphall/Documents/Programs/esp/src/lib/components/form/FormElement.svelte", "Svelte", 0, 107, 1, 10, 118
"/Users/phylliphall/Documents/Programs/esp/src/lib/components/form/FormLabel.svelte", "Svelte", 0, 36, 1, 6, 43
"/Users/phylliphall/Documents/Programs/esp/src/lib/components/form/FormListCard.svelte", "Svelte", 0, 88, 0, 12, 100
"/Users/phylliphall/Documents/Programs/esp/src/lib/components/form/FormListGrid.svelte", "Svelte", 0, 367, 0, 40, 407
"/Users/phylliphall/Documents/Programs/esp/src/lib/components/form/ListFilter.svelte", "Svelte", 0, 35, 0, 4, 39
"/Users/phylliphall/Documents/Programs/esp/src/lib/components/form/field.svelte.ts", "TypeScript", 412, 0, 7, 43, 462
"/Users/phylliphall/Documents/Programs/esp/src/lib/components/form/fieldCheckbox.ts", "TypeScript", 14, 0, 0, 2, 16
"/Users/phylliphall/Documents/Programs/esp/src/lib/components/form/fieldChips.ts", "TypeScript", 6, 0, 0, 2, 8
"/Users/phylliphall/Documents/Programs/esp/src/lib/components/form/fieldCustom.ts", "TypeScript", 111, 0, 0, 8, 119
"/Users/phylliphall/Documents/Programs/esp/src/lib/components/form/fieldEmbed.ts", "TypeScript", 207, 0, 0, 16, 223
"/Users/phylliphall/Documents/Programs/esp/src/lib/components/form/fieldEmbedShell.ts", "TypeScript", 38, 0, 1, 4, 43
"/Users/phylliphall/Documents/Programs/esp/src/lib/components/form/fieldFile.ts", "TypeScript", 34, 0, 0, 4, 38
"/Users/phylliphall/Documents/Programs/esp/src/lib/components/form/fieldInput.ts", "TypeScript", 183, 0, 18, 20, 221
"/Users/phylliphall/Documents/Programs/esp/src/lib/components/form/fieldList.ts", "TypeScript", 7, 0, 0, 3, 10
"/Users/phylliphall/Documents/Programs/esp/src/lib/components/form/fieldParm.ts", "TypeScript", 75, 0, 0, 7, 82
"/Users/phylliphall/Documents/Programs/esp/src/lib/components/form/fieldRadio.ts", "TypeScript", 10, 0, 0, 2, 12
"/Users/phylliphall/Documents/Programs/esp/src/lib/components/form/fieldSelect.ts", "TypeScript", 11, 0, 0, 3, 14
"/Users/phylliphall/Documents/Programs/esp/src/lib/components/form/fieldTag.ts", "TypeScript", 31, 0, 0, 5, 36
"/Users/phylliphall/Documents/Programs/esp/src/lib/components/form/fieldTextarea.ts", "TypeScript", 14, 0, 0, 3, 17
"/Users/phylliphall/Documents/Programs/esp/src/lib/components/form/fieldToggle.ts", "TypeScript", 38, 0, 0, 2, 40
"/Users/phylliphall/Documents/Programs/esp/src/lib/components/form/types.detailElement.ts", "TypeScript", 79, 0, 0, 15, 94
"/Users/phylliphall/Documents/Programs/esp/src/lib/components/form/types.source.ts", "TypeScript", 223, 0, 8, 20, 251
"/Users/phylliphall/Documents/Programs/esp/src/lib/components/form/types.validation.ts", "TypeScript", 59, 0, 0, 3, 62
"/Users/phylliphall/Documents/Programs/esp/src/lib/components/grid/Grid.svelte", "Svelte", 0, 346, 0, 40, 386
"/Users/phylliphall/Documents/Programs/esp/src/lib/components/grid/GridSelect.svelte", "Svelte", 0, 30, 0, 7, 37
"/Users/phylliphall/Documents/Programs/esp/src/lib/components/grid/grid.ts", "TypeScript", 324, 0, 0, 17, 341
"/Users/phylliphall/Documents/Programs/esp/src/lib/components/grid/gridParmField.ts", "TypeScript", 132, 0, 1, 20, 153
"/Users/phylliphall/Documents/Programs/esp/src/lib/components/icon/Icon.svelte", "Svelte", 0, 110, 1, 5, 116
"/Users/phylliphall/Documents/Programs/esp/src/lib/components/icon/types.icon.ts", "TypeScript", 24, 0, 1, 3, 28
"/Users/phylliphall/Documents/Programs/esp/src/lib/components/layout/LayoutApp.svelte", "Svelte", 0, 11, 0, 2, 13
"/Users/phylliphall/Documents/Programs/esp/src/lib/components/layout/LayoutContent.svelte", "Svelte", 0, 91, 0, 10, 101
"/Users/phylliphall/Documents/Programs/esp/src/lib/components/layout/LayoutProcess.svelte", "Svelte", 0, 7, 0, 4, 11
"/Users/phylliphall/Documents/Programs/esp/src/lib/components/layout/LayoutTab.svelte", "Svelte", 0, 84, 0, 10, 94
"/Users/phylliphall/Documents/Programs/esp/src/lib/components/layout/RootLayoutApp.svelte", "Svelte", 0, 30, 0, 5, 35
"/Users/phylliphall/Documents/Programs/esp/src/lib/components/layout/RootLayoutModal.svelte", "Svelte", 0, 91, 0, 11, 102
"/Users/phylliphall/Documents/Programs/esp/src/lib/components/layout/layoutDash/LayoutDashboard.svelte", "Svelte", 0, 163, 3, 14, 180
"/Users/phylliphall/Documents/Programs/esp/src/lib/components/layout/layoutDash/tso_data.svelte", "Svelte", 0, 27, 1, 6, 34
"/Users/phylliphall/Documents/Programs/esp/src/lib/components/layout/layoutDash/tso_moed_ssr_advocate.svelte", "Svelte", 0, 36, 1, 7, 44
"/Users/phylliphall/Documents/Programs/esp/src/lib/components/layout/layoutDash/tso_moed_ssr_app.svelte", "Svelte", 0, 31, 1, 6, 38
"/Users/phylliphall/Documents/Programs/esp/src/lib/components/layout/layoutDash/tso_moed_ssr_doc.svelte", "Svelte", 0, 29, 0, 7, 36
"/Users/phylliphall/Documents/Programs/esp/src/lib/components/layout/layoutDash/tso_moed_ssr_msg.svelte", "Svelte", 0, 28, 1, 6, 35
"/Users/phylliphall/Documents/Programs/esp/src/lib/components/nav/NavApp.svelte", "Svelte", 0, 52, 0, 6, 58
"/Users/phylliphall/Documents/Programs/esp/src/lib/components/nav/NavAppMobile.svelte", "Svelte", 0, 38, 0, 7, 45
"/Users/phylliphall/Documents/Programs/esp/src/lib/components/nav/NavCrumbsDesktop.svelte", "Svelte", 0, 92, 0, 5, 97
"/Users/phylliphall/Documents/Programs/esp/src/lib/components/nav/NavCrumbsMobile.svelte", "Svelte", 0, 44, 0, 5, 49
"/Users/phylliphall/Documents/Programs/esp/src/lib/components/nav/NavRow.svelte", "Svelte", 0, 60, 0, 6, 66
"/Users/phylliphall/Documents/Programs/esp/src/lib/components/nav/NavRowAction.svelte", "Svelte", 0, 14, 0, 3, 17
"/Users/phylliphall/Documents/Programs/esp/src/lib/components/nav/navMenu/NavMenu.svelte", "Svelte", 0, 47, 0, 7, 54
"/Users/phylliphall/Documents/Programs/esp/src/lib/components/nav/navMenu/NavMenuApps.svelte", "Svelte", 0, 20, 0, 5, 25
"/Users/phylliphall/Documents/Programs/esp/src/lib/components/nav/navMenu/NavMenuCopyright.svelte", "Svelte", 0, 14, 0, 4, 18
"/Users/phylliphall/Documents/Programs/esp/src/lib/components/nav/navMenu/NavMenuGroup.svelte", "Svelte", 0, 30, 0, 4, 34
"/Users/phylliphall/Documents/Programs/esp/src/lib/components/nav/navMenu/NavMenuHeader.svelte", "Svelte", 0, 10, 0, 3, 13
"/Users/phylliphall/Documents/Programs/esp/src/lib/components/nav/navMenu/NavMenuHr.svelte", "Svelte", 0, 8, 0, 3, 11
"/Users/phylliphall/Documents/Programs/esp/src/lib/components/nav/navMenu/NavMenuInfo.svelte", "Svelte", 0, 13, 0, 3, 16
"/Users/phylliphall/Documents/Programs/esp/src/lib/components/nav/navMenu/NavMenuItem.svelte", "Svelte", 0, 65, 0, 6, 71
"/Users/phylliphall/Documents/Programs/esp/src/lib/components/nav/navMenu/NavMenuOrg.svelte", "Svelte", 0, 48, 0, 7, 55
"/Users/phylliphall/Documents/Programs/esp/src/lib/components/nav/navMenu/NavMenuUser.svelte", "Svelte", 0, 41, 0, 7, 48
"/Users/phylliphall/Documents/Programs/esp/src/lib/components/nav/navMenu/types.navMenu.svelte.ts", "TypeScript", 444, 0, 55, 39, 538
"/Users/phylliphall/Documents/Programs/esp/src/lib/components/other/AddressSelect.svelte", "Svelte", 0, 8, 37, 4, 49
"/Users/phylliphall/Documents/Programs/esp/src/lib/components/other/UnderConstruction.svelte", "Svelte", 0, 12, 0, 4, 16
"/Users/phylliphall/Documents/Programs/esp/src/lib/components/other/types.userAction.svelte.ts", "TypeScript", 328, 0, 0, 20, 348
"/Users/phylliphall/Documents/Programs/esp/src/lib/components/overlay/OverlayDrawer.svelte", "Svelte", 0, 29, 0, 7, 36
"/Users/phylliphall/Documents/Programs/esp/src/lib/components/overlay/OverlayModal.svelte", "Svelte", 0, 9, 0, 2, 11
"/Users/phylliphall/Documents/Programs/esp/src/lib/enhancements/actions/actionsClassDo.ts", "TypeScript", 258, 0, 2, 28, 288
"/Users/phylliphall/Documents/Programs/esp/src/lib/enhancements/actions/actionsClassDoFieldAuth.ts", "TypeScript", 208, 0, 6, 23, 237
"/Users/phylliphall/Documents/Programs/esp/src/lib/enhancements/actions/actionsClassModal.ts", "TypeScript", 37, 0, 0, 8, 45
"/Users/phylliphall/Documents/Programs/esp/src/lib/enhancements/actions/actionsClassNav.ts", "TypeScript", 99, 0, 0, 14, 113
"/Users/phylliphall/Documents/Programs/esp/src/lib/enhancements/actions/actionsClassUtils.ts", "TypeScript", 55, 0, 0, 9, 64
"/Users/phylliphall/Documents/Programs/esp/src/lib/enhancements/queryRiderFunctions/qrfFileStorage.ts", "TypeScript", 108, 0, 1, 17, 126
"/Users/phylliphall/Documents/Programs/esp/src/lib/enhancements/queryRiderFunctions/qrfUserUpdate.ts", "TypeScript", 22, 0, 0, 3, 25
"/Users/phylliphall/Documents/Programs/esp/src/lib/server/apiSendGrid.ts", "TypeScript", 64, 0, 2, 12, 78
"/Users/phylliphall/Documents/Programs/esp/src/lib/server/dbESP.ts", "TypeScript", 287, 0, 26, 29, 342
"/Users/phylliphall/Documents/Programs/esp/src/lib/server/dbEdge/init/dbEdgeInit.ts", "TypeScript", 47, 0, 8, 13, 68
"/Users/phylliphall/Documents/Programs/esp/src/lib/server/dbEdge/init/dbEdgeInit1User.ts", "TypeScript", 530, 0, 30, 23, 583
"/Users/phylliphall/Documents/Programs/esp/src/lib/server/dbEdge/init/dbEdgeInit200Utilities10.ts", "TypeScript", 114, 0, 0, 7, 121
"/Users/phylliphall/Documents/Programs/esp/src/lib/server/dbEdge/init/dbEdgeInit200Utilities20DataObj.ts", "TypeScript", 559, 0, 3, 52, 614
"/Users/phylliphall/Documents/Programs/esp/src/lib/server/dbEdge/init/dbEdgeInit200Utilities30DB.ts", "TypeScript", 102, 0, 0, 3, 105
"/Users/phylliphall/Documents/Programs/esp/src/lib/server/dbEdge/init/dbEdgeInit200Utilities40Rep.ts", "TypeScript", 205, 0, 0, 3, 208
"/Users/phylliphall/Documents/Programs/esp/src/lib/server/dbEdge/init/dbEdgeInit200Utilities50Other.ts", "TypeScript", 629, 0, 9, 20, 658
"/Users/phylliphall/Documents/Programs/esp/src/lib/server/dbEdge/init/dbEdgeInit200Utilities60OrgMOED.ts", "TypeScript", 142, 0, 0, 5, 147
"/Users/phylliphall/Documents/Programs/esp/src/lib/server/dbEdge/init/dbEdgeInit30PreCode.ts", "TypeScript", 35, 0, 0, 3, 38
"/Users/phylliphall/Documents/Programs/esp/src/lib/server/dbEdge/init/dbEdgeInit30PreCodeAction.ts", "TypeScript", 279, 0, 0, 8, 287
"/Users/phylliphall/Documents/Programs/esp/src/lib/server/dbEdge/init/dbEdgeInit40PreDO.ts", "TypeScript", 19, 0, 0, 5, 24
"/Users/phylliphall/Documents/Programs/esp/src/lib/server/dbEdge/init/dbEdgeInit40PreDOColumn.ts", "TypeScript", 2447, 0, 2, 5, 2454
"/Users/phylliphall/Documents/Programs/esp/src/lib/server/dbEdge/init/dbEdgeInit40PreDODataObjActionGroup.ts", "TypeScript", 350, 0, 7, 11, 368
"/Users/phylliphall/Documents/Programs/esp/src/lib/server/dbEdge/init/dbEdgeInit40PreDODataObjFieldItem.ts", "TypeScript", 353, 0, 8, 21, 382
"/Users/phylliphall/Documents/Programs/esp/src/lib/server/dbEdge/init/dbEdgeInit40PreDOEmbedListConfig.ts", "TypeScript", 1310, 0, 20, 34, 1364
"/Users/phylliphall/Documents/Programs/esp/src/lib/server/dbEdge/init/dbEdgeInit40PreDOEmbedListSelect.ts", "TypeScript", 130, 0, 0, 8, 138
"/Users/phylliphall/Documents/Programs/esp/src/lib/server/dbEdge/init/dbEdgeInit40PreDOTable.ts", "TypeScript", 88, 0, 9, 10, 107
"/Users/phylliphall/Documents/Programs/esp/src/lib/server/dbEdge/init/dbEdgeInit40PreDOTableColumn.ts", "TypeScript", 72, 0, 0, 6, 78
"/Users/phylliphall/Documents/Programs/esp/src/lib/server/dbEdge/init/dbEdgeInit40PreUserAction.ts", "TypeScript", 298, 0, 0, 25, 323
"/Users/phylliphall/Documents/Programs/esp/src/lib/server/dbEdge/init/dbEdgeInit60SysAdmin.ts", "TypeScript", 13, 0, 0, 3, 16
"/Users/phylliphall/Documents/Programs/esp/src/lib/server/dbEdge/init/dbEdgeInit60SysAdmin10OrgSys.ts", "TypeScript", 191, 0, 1, 7, 199
"/Users/phylliphall/Documents/Programs/esp/src/lib/server/dbEdge/init/dbEdgeInit60SysAdmin15OrgUser.ts", "TypeScript", 794, 0, 3, 21, 818
"/Users/phylliphall/Documents/Programs/esp/src/lib/server/dbEdge/init/dbEdgeInit60SysAdmin20SysConfig.ts", "TypeScript", 209, 0, 1, 7, 217
"/Users/phylliphall/Documents/Programs/esp/src/lib/server/dbEdge/init/dbEdgeInit60SysAdmin30SysObj.ts", "TypeScript", 187, 0, 1, 7, 195
"/Users/phylliphall/Documents/Programs/esp/src/lib/server/dbEdge/init/dbEdgeInit60SysAdmin30SysObjApp.ts", "TypeScript", 467, 0, 2, 14, 483
"/Users/phylliphall/Documents/Programs/esp/src/lib/server/dbEdge/init/dbEdgeInit60SysAdmin30SysObjCode.ts", "TypeScript", 904, 0, 22, 13, 939
"/Users/phylliphall/Documents/Programs/esp/src/lib/server/dbEdge/init/dbEdgeInit60SysAdmin30SysObjDB.ts", "TypeScript", 757, 0, 3, 11, 771
"/Users/phylliphall/Documents/Programs/esp/src/lib/server/dbEdge/init/dbEdgeInit60SysAdmin30SysObjDataObj.ts", "TypeScript", 1383, 0, 11, 23, 1417
"/Users/phylliphall/Documents/Programs/esp/src/lib/server/dbEdge/init/dbEdgeInit60SysAdmin30SysObjDataObjEmbed.ts", "TypeScript", 632, 0, 3, 16, 651
"/Users/phylliphall/Documents/Programs/esp/src/lib/server/dbEdge/init/dbEdgeInit60SysAdmin30SysObjDataObjFieldItmes.ts", "TypeScript", 315, 0, 1, 7, 323
"/Users/phylliphall/Documents/Programs/esp/src/lib/server/dbEdge/init/dbEdgeInit60SysAdmin30SysObjMigration.ts", "TypeScript", 999, 0, 7, 31, 1037
"/Users/phylliphall/Documents/Programs/esp/src/lib/server/dbEdge/init/dbEdgeInit60SysAdmin30SysObjNodeObj.ts", "TypeScript", 357, 0, 2, 8, 367
"/Users/phylliphall/Documents/Programs/esp/src/lib/server/dbEdge/init/dbEdgeInit60SysAdmin30SysObjRep.ts", "TypeScript", 2064, 0, 10, 28, 2102
"/Users/phylliphall/Documents/Programs/esp/src/lib/server/dbEdge/init/dbEdgeInit60SysAdmin30SysObjTask.ts", "TypeScript", 382, 0, 1, 7, 390
"/Users/phylliphall/Documents/Programs/esp/src/lib/server/dbEdge/init/dbEdgeInit60SysAdmin30SysObjUserAction.ts", "TypeScript", 550, 0, 3, 15, 568
"/Users/phylliphall/Documents/Programs/esp/src/lib/server/dbEdge/init/dbEdgeInit60SysAdmin30SysObjWidget.ts", "TypeScript", 196, 0, 1, 7, 204
"/Users/phylliphall/Documents/Programs/esp/src/lib/server/dbEdge/init/dbEdgeInit60SysAdmin40SysMeta.ts", "TypeScript", 144, 0, 1, 7, 152
"/Users/phylliphall/Documents/Programs/esp/src/lib/server/dbEdge/init/dbEdgeInit60SysAdmin40SysMetaUserType.ts", "TypeScript", 336, 0, 1, 9, 346
"/Users/phylliphall/Documents/Programs/esp/src/lib/server/dbEdge/init/dbEdgeInit60SysAdminAuth.ts", "TypeScript", 803, 0, 15, 17, 835
"/Users/phylliphall/Documents/Programs/esp/src/lib/server/dbEdge/init/dbEdgeInit60SysAdminRepUser.ts", "TypeScript", 536, 0, 23, 12, 571
"/Users/phylliphall/Documents/Programs/esp/src/lib/server/dbEdge/init/dbEdgeInit80ContentAIRep.ts", "TypeScript", 1685, 0, 3, 23, 1711
"/Users/phylliphall/Documents/Programs/esp/src/lib/server/dbEdge/init/dbEdgeInit80ContentAIStudent.ts", "TypeScript", 2222, 0, 37, 27, 2286
"/Users/phylliphall/Documents/Programs/esp/src/lib/server/dbEdge/init/dbEdgeInit80ContentAITraining.ts", "TypeScript", 1949, 0, 11, 33, 1993
"/Users/phylliphall/Documents/Programs/esp/src/lib/server/dbEdge/init/dbEdgeInit80ContentCrm.ts", "TypeScript", 187, 0, 3, 7, 197
"/Users/phylliphall/Documents/Programs/esp/src/lib/server/dbEdge/init/dbEdgeInit80ContentCrmRep.ts", "TypeScript", 66, 0, 0, 4, 70
"/Users/phylliphall/Documents/Programs/esp/src/lib/server/dbEdge/init/dbEdgeInit80ContentMOEDCm.ts", "TypeScript", 1834, 0, 86, 22, 1942
"/Users/phylliphall/Documents/Programs/esp/src/lib/server/dbEdge/init/dbEdgeInit80ContentMOEDCmAdvocate.ts", "TypeScript", 309, 0, 21, 9, 339
"/Users/phylliphall/Documents/Programs/esp/src/lib/server/dbEdge/init/dbEdgeInit80ContentMOEDRep.ts", "TypeScript", 2, 0, 0, 2, 4
"/Users/phylliphall/Documents/Programs/esp/src/lib/server/dbEdge/init/dbEdgeInit80ContentMOEDSSR.ts", "TypeScript", 1128, 0, 15, 26, 1169
"/Users/phylliphall/Documents/Programs/esp/src/lib/server/dbEdge/init/dbEdgeInit80ContentMigrPerson.ts", "TypeScript", 52, 0, 85, 4, 141
"/Users/phylliphall/Documents/Programs/esp/src/lib/server/dbEdge/init/types.init.ts", "TypeScript", 601, 0, 7, 53, 661
"/Users/phylliphall/Documents/Programs/esp/src/lib/server/dbEdge/initOld/dbEdgeInitOldCMDataAI.ts", "TypeScript", 154, 0, 0, 10, 164
"/Users/phylliphall/Documents/Programs/esp/src/lib/server/dbEdge/initOld/dbEdgeInitOldCMDataMOED.ts", "TypeScript", 67, 0, 1, 6, 74
"/Users/phylliphall/Documents/Programs/esp/src/lib/server/dbEdge/initOld/dbEdgeInitOldCore.ts", "TypeScript", 226, 0, 27, 33, 286
"/Users/phylliphall/Documents/Programs/esp/src/lib/server/env.ts", "TypeScript", 4, 0, 0, 2, 6
"/Users/phylliphall/Documents/Programs/esp/src/lib/utils/DataViewer.svelte", "Svelte", 0, 12, 0, 2, 14
"/Users/phylliphall/Documents/Programs/esp/src/lib/utils/types.token.ts", "TypeScript", 505, 0, 1, 40, 546
"/Users/phylliphall/Documents/Programs/esp/src/lib/utils/types.ts", "TypeScript", 8, 0, 1, 1, 10
"/Users/phylliphall/Documents/Programs/esp/src/lib/utils/types.user.ts", "TypeScript", 288, 0, 69, 31, 388
"/Users/phylliphall/Documents/Programs/esp/src/lib/utils/utils.appstore.ts", "TypeScript", 34, 0, 4, 5, 43
"/Users/phylliphall/Documents/Programs/esp/src/lib/utils/utils.array.ts", "TypeScript", 33, 0, 1, 5, 39
"/Users/phylliphall/Documents/Programs/esp/src/lib/utils/utils.date.ts", "TypeScript", 31, 0, 5, 4, 40
"/Users/phylliphall/Documents/Programs/esp/src/lib/utils/utils.debug.ts", "TypeScript", 12, 0, 0, 2, 14
"/Users/phylliphall/Documents/Programs/esp/src/lib/utils/utils.error.ts", "TypeScript", 25, 0, 1, 7, 33
"/Users/phylliphall/Documents/Programs/esp/src/lib/utils/utils.model.ts", "TypeScript", 204, 0, 2, 13, 219
"/Users/phylliphall/Documents/Programs/esp/src/lib/utils/utils.process.ts", "TypeScript", 35, 0, 0, 4, 39
"/Users/phylliphall/Documents/Programs/esp/src/lib/utils/utils.processMigrate.ts", "TypeScript", 28, 0, 0, 4, 32
"/Users/phylliphall/Documents/Programs/esp/src/lib/utils/utils.randomDataGenerator.ts", "TypeScript", 389, 0, 2, 31, 422
"/Users/phylliphall/Documents/Programs/esp/src/lib/utils/utils.report.ts", "TypeScript", 5, 0, 0, 1, 6
"/Users/phylliphall/Documents/Programs/esp/src/lib/utils/utils.sys.ts", "TypeScript", 152, 0, 9, 23, 184
"/Users/phylliphall/Documents/Programs/esp/src/lib/utils/utils.ts", "TypeScript", 8, 0, 0, 1, 9
"Total", "-", 40348, 3632, 859, 2234, 47073