"filename", "language", "TypeScript", "Svelte", "comment", "blank", "total"
"/Users/phylliphall/Documents/Programs/esp/src/lib/components/app/types.app.svelte.ts", "TypeScript", 827, 0, 32, 73, 932
"/Users/phylliphall/Documents/Programs/esp/src/lib/components/app/types.appQuery.ts", "TypeScript", 162, 0, 8, 27, 197
"/Users/phylliphall/Documents/Programs/esp/src/lib/components/app/types.appState.svelte.ts", "TypeScript", 566, 0, 2, 59, 627
"/Users/phylliphall/Documents/Programs/esp/src/lib/components/app/types.node.ts", "TypeScript", 147, 0, 0, 10, 157
"/Users/phylliphall/Documents/Programs/esp/src/lib/components/dataObj/DataObjActionsObj.svelte", "Svelte", 0, 68, 0, 9, 77
"/Users/phylliphall/Documents/Programs/esp/src/lib/components/dataObj/types.dataManager.svelte.ts", "TypeScript", 397, 0, 5, 41, 443
"/Users/phylliphall/Documents/Programs/esp/src/lib/components/dataObj/types.dataObj.svelte.ts", "TypeScript", 954, 0, 5, 82, 1041
"/Users/phylliphall/Documents/Programs/esp/src/lib/components/dataObj/types.rawDataObj.svelte.ts", "TypeScript", 954, 0, 9, 62, 1025
"/Users/phylliphall/Documents/Programs/esp/src/lib/components/dataObj/types.rep.ts", "TypeScript", 272, 0, 2, 12, 286
"/Users/phylliphall/Documents/Programs/esp/src/lib/components/form/ContentFormDetailApp.svelte", "Svelte", 0, 6, 0, 2, 8
"/Users/phylliphall/Documents/Programs/esp/src/lib/components/form/ContentFormDetailRepConfig.svelte", "Svelte", 0, 6, 0, 2, 8
"/Users/phylliphall/Documents/Programs/esp/src/lib/components/form/ContentFormListApp.svelte", "Svelte", 0, 12, 0, 4, 16
"/Users/phylliphall/Documents/Programs/esp/src/lib/components/form/FormDetail.svelte", "Svelte", 0, 41, 1, 13, 55
"/Users/phylliphall/Documents/Programs/esp/src/lib/components/form/FormDetailEl.svelte", "Svelte", 0, 27, 0, 7, 34
"/Users/phylliphall/Documents/Programs/esp/src/lib/components/form/FormDetailElField.svelte", "Svelte", 0, 20, 0, 4, 24
"/Users/phylliphall/Documents/Programs/esp/src/lib/components/form/FormDetailElGroupDetails.svelte", "Svelte", 0, 19, 0, 4, 23
"/Users/phylliphall/Documents/Programs/esp/src/lib/components/form/FormDetailElGroupRow.svelte", "Svelte", 0, 14, 0, 4, 18
"/Users/phylliphall/Documents/Programs/esp/src/lib/components/form/FormDetailElGroupSection.svelte", "Svelte", 0, 20, 0, 5, 25
"/Users/phylliphall/Documents/Programs/esp/src/lib/components/form/FormElChips.svelte", "Svelte", 0, 106, 2, 7, 115
"/Users/phylliphall/Documents/Programs/esp/src/lib/components/form/FormElCustomActionButton.svelte", "Svelte", 0, 41, 0, 6, 47
"/Users/phylliphall/Documents/Programs/esp/src/lib/components/form/FormElCustomActionLink.svelte", "Svelte", 0, 37, 0, 6, 43
"/Users/phylliphall/Documents/Programs/esp/src/lib/components/form/FormElCustomHTML.svelte", "Svelte", 0, 8, 0, 2, 10
"/Users/phylliphall/Documents/Programs/esp/src/lib/components/form/FormElCustomHeader.svelte", "Svelte", 0, 23, 0, 4, 27
"/Users/phylliphall/Documents/Programs/esp/src/lib/components/form/FormElCustomText.svelte", "Svelte", 0, 12, 0, 4, 16
"/Users/phylliphall/Documents/Programs/esp/src/lib/components/form/FormElEmbedListConfig.svelte", "Svelte", 0, 26, 1, 7, 34
"/Users/phylliphall/Documents/Programs/esp/src/lib/components/form/FormElEmbedListEdit.svelte", "Svelte", 0, 31, 1, 7, 39
"/Users/phylliphall/Documents/Programs/esp/src/lib/components/form/FormElEmbedListSelect.svelte", "Svelte", 0, 55, 0, 7, 62
"/Users/phylliphall/Documents/Programs/esp/src/lib/components/form/FormElEmbedShell.svelte", "Svelte", 0, 64, 7, 16, 87
"/Users/phylliphall/Documents/Programs/esp/src/lib/components/form/FormElFile.svelte", "Svelte", 0, 155, 3, 17, 175
"/Users/phylliphall/Documents/Programs/esp/src/lib/components/form/FormElInp.svelte", "Svelte", 0, 155, 7, 19, 181
"/Users/phylliphall/Documents/Programs/esp/src/lib/components/form/FormElInpCheckbox.svelte", "Svelte", 0, 69, 1, 9, 79
"/Users/phylliphall/Documents/Programs/esp/src/lib/components/form/FormElInpRadio.svelte", "Svelte", 0, 66, 1, 9, 76
"/Users/phylliphall/Documents/Programs/esp/src/lib/components/form/FormElSelect.svelte", "Svelte", 0, 66, 2, 9, 77
"/Users/phylliphall/Documents/Programs/esp/src/lib/components/form/FormElTextarea.svelte", "Svelte", 0, 39, 0, 8, 47
"/Users/phylliphall/Documents/Programs/esp/src/lib/components/form/FormElToggle.svelte", "Svelte", 0, 39, 0, 7, 46
"/Users/phylliphall/Documents/Programs/esp/src/lib/components/form/FormElement.svelte", "Svelte", 0, 107, 1, 10, 118
"/Users/phylliphall/Documents/Programs/esp/src/lib/components/form/FormLabel.svelte", "Svelte", 0, 36, 1, 6, 43
"/Users/phylliphall/Documents/Programs/esp/src/lib/components/form/FormListCard.svelte", "Svelte", 0, 88, 0, 12, 100
"/Users/phylliphall/Documents/Programs/esp/src/lib/components/form/FormListGrid.svelte", "Svelte", 0, 367, 0, 40, 407
"/Users/phylliphall/Documents/Programs/esp/src/lib/components/form/ListFilter.svelte", "Svelte", 0, 35, 0, 4, 39
"/Users/phylliphall/Documents/Programs/esp/src/lib/components/form/field.svelte.ts", "TypeScript", 410, 0, 7, 43, 460
"/Users/phylliphall/Documents/Programs/esp/src/lib/components/form/fieldCheckbox.ts", "TypeScript", 14, 0, 0, 2, 16
"/Users/phylliphall/Documents/Programs/esp/src/lib/components/form/fieldChips.ts", "TypeScript", 6, 0, 0, 2, 8
"/Users/phylliphall/Documents/Programs/esp/src/lib/components/form/fieldCustom.ts", "TypeScript", 111, 0, 0, 8, 119
"/Users/phylliphall/Documents/Programs/esp/src/lib/components/form/fieldEmbed.ts", "TypeScript", 209, 0, 0, 16, 225
"/Users/phylliphall/Documents/Programs/esp/src/lib/components/form/fieldEmbedShell.ts", "TypeScript", 38, 0, 1, 4, 43
"/Users/phylliphall/Documents/Programs/esp/src/lib/components/form/fieldFile.ts", "TypeScript", 34, 0, 0, 4, 38
"/Users/phylliphall/Documents/Programs/esp/src/lib/components/form/fieldInput.ts", "TypeScript", 183, 0, 18, 20, 221
"/Users/phylliphall/Documents/Programs/esp/src/lib/components/form/fieldList.ts", "TypeScript", 7, 0, 0, 3, 10
"/Users/phylliphall/Documents/Programs/esp/src/lib/components/form/fieldParm.ts", "TypeScript", 71, 0, 0, 7, 78
"/Users/phylliphall/Documents/Programs/esp/src/lib/components/form/fieldRadio.ts", "TypeScript", 10, 0, 0, 2, 12
"/Users/phylliphall/Documents/Programs/esp/src/lib/components/form/fieldSelect.ts", "TypeScript", 11, 0, 0, 3, 14
"/Users/phylliphall/Documents/Programs/esp/src/lib/components/form/fieldTag.ts", "TypeScript", 31, 0, 0, 5, 36
"/Users/phylliphall/Documents/Programs/esp/src/lib/components/form/fieldTextarea.ts", "TypeScript", 14, 0, 0, 3, 17
"/Users/phylliphall/Documents/Programs/esp/src/lib/components/form/fieldToggle.ts", "TypeScript", 38, 0, 0, 2, 40
"/Users/phylliphall/Documents/Programs/esp/src/lib/components/form/types.detailElement.ts", "TypeScript", 79, 0, 0, 15, 94
"/Users/phylliphall/Documents/Programs/esp/src/lib/components/form/types.source.ts", "TypeScript", 223, 0, 8, 20, 251
"/Users/phylliphall/Documents/Programs/esp/src/lib/components/form/types.validation.ts", "TypeScript", 59, 0, 0, 3, 62
"/Users/phylliphall/Documents/Programs/esp/src/lib/components/grid/Grid.svelte", "Svelte", 0, 348, 0, 40, 388
"/Users/phylliphall/Documents/Programs/esp/src/lib/components/grid/GridSelect.svelte", "Svelte", 0, 30, 0, 7, 37
"/Users/phylliphall/Documents/Programs/esp/src/lib/components/grid/grid.ts", "TypeScript", 324, 0, 0, 17, 341
"/Users/phylliphall/Documents/Programs/esp/src/lib/components/grid/gridParmField.ts", "TypeScript", 132, 0, 1, 20, 153
"/Users/phylliphall/Documents/Programs/esp/src/lib/components/icon/Icon.svelte", "Svelte", 0, 110, 1, 5, 116
"/Users/phylliphall/Documents/Programs/esp/src/lib/components/icon/types.icon.ts", "TypeScript", 24, 0, 1, 3, 28
"/Users/phylliphall/Documents/Programs/esp/src/lib/components/layout/LayoutApp.svelte", "Svelte", 0, 11, 0, 2, 13
"/Users/phylliphall/Documents/Programs/esp/src/lib/components/layout/LayoutContent.svelte", "Svelte", 0, 91, 0, 10, 101
"/Users/phylliphall/Documents/Programs/esp/src/lib/components/layout/LayoutProcess.svelte", "Svelte", 0, 7, 0, 4, 11
"/Users/phylliphall/Documents/Programs/esp/src/lib/components/layout/LayoutTab.svelte", "Svelte", 0, 84, 0, 10, 94
"/Users/phylliphall/Documents/Programs/esp/src/lib/components/layout/RootLayoutApp.svelte", "Svelte", 0, 30, 0, 5, 35
"/Users/phylliphall/Documents/Programs/esp/src/lib/components/layout/RootLayoutModal.svelte", "Svelte", 0, 91, 0, 11, 102
"/Users/phylliphall/Documents/Programs/esp/src/lib/components/layout/layoutDash/LayoutDashboard.svelte", "Svelte", 0, 159, 0, 14, 173
"/Users/phylliphall/Documents/Programs/esp/src/lib/components/layout/layoutDash/tso_moed_ssr_doc.svelte", "Svelte", 0, 29, 0, 7, 36
"/Users/phylliphall/Documents/Programs/esp/src/lib/components/layout/layoutDash/tso_sys_data.svelte", "Svelte", 0, 35, 1, 7, 43
"/Users/phylliphall/Documents/Programs/esp/src/lib/components/layout/layoutDash/tso_sys_quote.svelte", "Svelte", 0, 45, 0, 6, 51
"/Users/phylliphall/Documents/Programs/esp/src/lib/components/nav/NavApp.svelte", "Svelte", 0, 52, 0, 6, 58
"/Users/phylliphall/Documents/Programs/esp/src/lib/components/nav/NavAppMobile.svelte", "Svelte", 0, 38, 0, 7, 45
"/Users/phylliphall/Documents/Programs/esp/src/lib/components/nav/NavCrumbsDesktop.svelte", "Svelte", 0, 92, 0, 5, 97
"/Users/phylliphall/Documents/Programs/esp/src/lib/components/nav/NavCrumbsMobile.svelte", "Svelte", 0, 44, 0, 5, 49
"/Users/phylliphall/Documents/Programs/esp/src/lib/components/nav/NavRow.svelte", "Svelte", 0, 60, 0, 6, 66
"/Users/phylliphall/Documents/Programs/esp/src/lib/components/nav/NavRowAction.svelte", "Svelte", 0, 14, 0, 3, 17
"/Users/phylliphall/Documents/Programs/esp/src/lib/components/nav/navMenu/NavMenu.svelte", "Svelte", 0, 47, 0, 7, 54
"/Users/phylliphall/Documents/Programs/esp/src/lib/components/nav/navMenu/NavMenuApps.svelte", "Svelte", 0, 20, 0, 5, 25
"/Users/phylliphall/Documents/Programs/esp/src/lib/components/nav/navMenu/NavMenuCopyright.svelte", "Svelte", 0, 14, 0, 4, 18
"/Users/phylliphall/Documents/Programs/esp/src/lib/components/nav/navMenu/NavMenuGroup.svelte", "Svelte", 0, 30, 0, 4, 34
"/Users/phylliphall/Documents/Programs/esp/src/lib/components/nav/navMenu/NavMenuHeader.svelte", "Svelte", 0, 10, 0, 3, 13
"/Users/phylliphall/Documents/Programs/esp/src/lib/components/nav/navMenu/NavMenuHr.svelte", "Svelte", 0, 8, 0, 3, 11
"/Users/phylliphall/Documents/Programs/esp/src/lib/components/nav/navMenu/NavMenuInfo.svelte", "Svelte", 0, 13, 0, 3, 16
"/Users/phylliphall/Documents/Programs/esp/src/lib/components/nav/navMenu/NavMenuItem.svelte", "Svelte", 0, 65, 0, 6, 71
"/Users/phylliphall/Documents/Programs/esp/src/lib/components/nav/navMenu/NavMenuOrg.svelte", "Svelte", 0, 48, 0, 7, 55
"/Users/phylliphall/Documents/Programs/esp/src/lib/components/nav/navMenu/NavMenuUser.svelte", "Svelte", 0, 41, 0, 7, 48
"/Users/phylliphall/Documents/Programs/esp/src/lib/components/nav/navMenu/types.navMenu.svelte.ts", "TypeScript", 439, 0, 47, 40, 526
"/Users/phylliphall/Documents/Programs/esp/src/lib/components/other/AddressSelect.svelte", "Svelte", 0, 8, 37, 4, 49
"/Users/phylliphall/Documents/Programs/esp/src/lib/components/other/UnderConstruction.svelte", "Svelte", 0, 12, 0, 4, 16
"/Users/phylliphall/Documents/Programs/esp/src/lib/components/other/types.userAction.svelte.ts", "TypeScript", 328, 0, 0, 20, 348
"/Users/phylliphall/Documents/Programs/esp/src/lib/components/overlay/OverlayDrawer.svelte", "Svelte", 0, 29, 0, 7, 36
"/Users/phylliphall/Documents/Programs/esp/src/lib/components/overlay/OverlayModal.svelte", "Svelte", 0, 9, 0, 2, 11
"/Users/phylliphall/Documents/Programs/esp/src/lib/enhancements/actions/actionsClassAuth.ts", "TypeScript", 252, 0, 2, 29, 283
"/Users/phylliphall/Documents/Programs/esp/src/lib/enhancements/actions/actionsClassDo.ts", "TypeScript", 258, 0, 2, 28, 288
"/Users/phylliphall/Documents/Programs/esp/src/lib/enhancements/actions/actionsClassModal.ts", "TypeScript", 37, 0, 0, 8, 45
"/Users/phylliphall/Documents/Programs/esp/src/lib/enhancements/actions/actionsClassNav.ts", "TypeScript", 99, 0, 0, 14, 113
"/Users/phylliphall/Documents/Programs/esp/src/lib/enhancements/actions/actionsClassUtils.ts", "TypeScript", 45, 0, 0, 8, 53
"/Users/phylliphall/Documents/Programs/esp/src/lib/enhancements/actions/types.actionsClassAuth.ts", "TypeScript", 141, 0, 0, 13, 154
"/Users/phylliphall/Documents/Programs/esp/src/lib/enhancements/queryRiderFunctions/qrfFileStorage.ts", "TypeScript", 109, 0, 1, 14, 124
"/Users/phylliphall/Documents/Programs/esp/src/lib/enhancements/queryRiderFunctions/qrfUserUpdate.ts", "TypeScript", 22, 0, 0, 3, 25
"/Users/phylliphall/Documents/Programs/esp/src/lib/server/apiSendGrid.ts", "TypeScript", 64, 0, 2, 12, 78
"/Users/phylliphall/Documents/Programs/esp/src/lib/server/dbESP.ts", "TypeScript", 287, 0, 26, 29, 342
"/Users/phylliphall/Documents/Programs/esp/src/lib/server/dbGel/init/dbGelInit.ts", "TypeScript", 49, 0, 15, 15, 79
"/Users/phylliphall/Documents/Programs/esp/src/lib/server/dbGel/init/dbGelInit1User.ts", "TypeScript", 564, 0, 30, 24, 618
"/Users/phylliphall/Documents/Programs/esp/src/lib/server/dbGel/init/dbGelInit200Utilities10.ts", "TypeScript", 99, 0, 0, 6, 105
"/Users/phylliphall/Documents/Programs/esp/src/lib/server/dbGel/init/dbGelInit200Utilities20DataObj.ts", "TypeScript", 557, 0, 3, 52, 612
"/Users/phylliphall/Documents/Programs/esp/src/lib/server/dbGel/init/dbGelInit200Utilities30DB.ts", "TypeScript", 102, 0, 0, 3, 105
"/Users/phylliphall/Documents/Programs/esp/src/lib/server/dbGel/init/dbGelInit200Utilities40Rep.ts", "TypeScript", 203, 0, 0, 3, 206
"/Users/phylliphall/Documents/Programs/esp/src/lib/server/dbGel/init/dbGelInit200Utilities50Other.ts", "TypeScript", 630, 0, 1, 18, 649
"/Users/phylliphall/Documents/Programs/esp/src/lib/server/dbGel/init/dbGelInit200Utilities60OrgMOED.ts", "TypeScript", 151, 0, 0, 5, 156
"/Users/phylliphall/Documents/Programs/esp/src/lib/server/dbGel/init/dbGelInit30PreCode.ts", "TypeScript", 53, 0, 0, 4, 57
"/Users/phylliphall/Documents/Programs/esp/src/lib/server/dbGel/init/dbGelInit30PreCodeAction.ts", "TypeScript", 279, 0, 0, 8, 287
"/Users/phylliphall/Documents/Programs/esp/src/lib/server/dbGel/init/dbGelInit40PreDO.ts", "TypeScript", 19, 0, 0, 5, 24
"/Users/phylliphall/Documents/Programs/esp/src/lib/server/dbGel/init/dbGelInit40PreDOColumn.ts", "TypeScript", 2446, 0, 2, 5, 2453
"/Users/phylliphall/Documents/Programs/esp/src/lib/server/dbGel/init/dbGelInit40PreDODataObjActionGroup.ts", "TypeScript", 350, 0, 7, 11, 368
"/Users/phylliphall/Documents/Programs/esp/src/lib/server/dbGel/init/dbGelInit40PreDODataObjFieldItem.ts", "TypeScript", 353, 0, 8, 21, 382
"/Users/phylliphall/Documents/Programs/esp/src/lib/server/dbGel/init/dbGelInit40PreDOEmbedListConfig.ts", "TypeScript", 1310, 0, 20, 34, 1364
"/Users/phylliphall/Documents/Programs/esp/src/lib/server/dbGel/init/dbGelInit40PreDOEmbedListSelect.ts", "TypeScript", 130, 0, 0, 8, 138
"/Users/phylliphall/Documents/Programs/esp/src/lib/server/dbGel/init/dbGelInit40PreDOTable.ts", "TypeScript", 87, 0, 9, 10, 106
"/Users/phylliphall/Documents/Programs/esp/src/lib/server/dbGel/init/dbGelInit40PreDOTableColumn.ts", "TypeScript", 72, 0, 0, 6, 78
"/Users/phylliphall/Documents/Programs/esp/src/lib/server/dbGel/init/dbGelInit40PreUserAction.ts", "TypeScript", 298, 0, 0, 25, 323
"/Users/phylliphall/Documents/Programs/esp/src/lib/server/dbGel/init/dbGelInit60SysAdmin.ts", "TypeScript", 13, 0, 0, 3, 16
"/Users/phylliphall/Documents/Programs/esp/src/lib/server/dbGel/init/dbGelInit60SysAdmin10OrgSys.ts", "TypeScript", 190, 0, 1, 7, 198
"/Users/phylliphall/Documents/Programs/esp/src/lib/server/dbGel/init/dbGelInit60SysAdmin15OrgUser.ts", "TypeScript", 719, 0, 3, 21, 743
"/Users/phylliphall/Documents/Programs/esp/src/lib/server/dbGel/init/dbGelInit60SysAdmin20SysConfig.ts", "TypeScript", 208, 0, 1, 7, 216
"/Users/phylliphall/Documents/Programs/esp/src/lib/server/dbGel/init/dbGelInit60SysAdmin30SysObj.ts", "TypeScript", 183, 0, 1, 7, 191
"/Users/phylliphall/Documents/Programs/esp/src/lib/server/dbGel/init/dbGelInit60SysAdmin30SysObjApp.ts", "TypeScript", 463, 0, 2, 14, 479
"/Users/phylliphall/Documents/Programs/esp/src/lib/server/dbGel/init/dbGelInit60SysAdmin30SysObjCode.ts", "TypeScript", 917, 0, 3, 13, 933
"/Users/phylliphall/Documents/Programs/esp/src/lib/server/dbGel/init/dbGelInit60SysAdmin30SysObjDB.ts", "TypeScript", 753, 0, 3, 11, 767
"/Users/phylliphall/Documents/Programs/esp/src/lib/server/dbGel/init/dbGelInit60SysAdmin30SysObjDataObj.ts", "TypeScript", 1370, 0, 11, 23, 1404
"/Users/phylliphall/Documents/Programs/esp/src/lib/server/dbGel/init/dbGelInit60SysAdmin30SysObjDataObjEmbed.ts", "TypeScript", 626, 0, 3, 16, 645
"/Users/phylliphall/Documents/Programs/esp/src/lib/server/dbGel/init/dbGelInit60SysAdmin30SysObjDataObjFieldItmes.ts", "TypeScript", 313, 0, 1, 7, 321
"/Users/phylliphall/Documents/Programs/esp/src/lib/server/dbGel/init/dbGelInit60SysAdmin30SysObjMigration.ts", "TypeScript", 989, 0, 7, 31, 1027
"/Users/phylliphall/Documents/Programs/esp/src/lib/server/dbGel/init/dbGelInit60SysAdmin30SysObjNodeObj.ts", "TypeScript", 364, 0, 2, 8, 374
"/Users/phylliphall/Documents/Programs/esp/src/lib/server/dbGel/init/dbGelInit60SysAdmin30SysObjRep.ts", "TypeScript", 2040, 0, 10, 28, 2078
"/Users/phylliphall/Documents/Programs/esp/src/lib/server/dbGel/init/dbGelInit60SysAdmin30SysObjTask.ts", "TypeScript", 367, 0, 1, 7, 375
"/Users/phylliphall/Documents/Programs/esp/src/lib/server/dbGel/init/dbGelInit60SysAdmin30SysObjUserAction.ts", "TypeScript", 544, 0, 3, 15, 562
"/Users/phylliphall/Documents/Programs/esp/src/lib/server/dbGel/init/dbGelInit60SysAdmin40SysMeta.ts", "TypeScript", 495, 0, 2, 12, 509
"/Users/phylliphall/Documents/Programs/esp/src/lib/server/dbGel/init/dbGelInit60SysAdmin40SysMetaUserType.ts", "TypeScript", 341, 0, 1, 9, 351
"/Users/phylliphall/Documents/Programs/esp/src/lib/server/dbGel/init/dbGelInit60SysAdminAuth.ts", "TypeScript", 815, 0, 3, 16, 834
"/Users/phylliphall/Documents/Programs/esp/src/lib/server/dbGel/init/dbGelInit60SysAdminRepUser.ts", "TypeScript", 534, 0, 23, 12, 569
"/Users/phylliphall/Documents/Programs/esp/src/lib/server/dbGel/init/dbGelInit80ContentAIRep.ts", "TypeScript", 1685, 0, 3, 23, 1711
"/Users/phylliphall/Documents/Programs/esp/src/lib/server/dbGel/init/dbGelInit80ContentAIStudent.ts", "TypeScript", 2200, 0, 37, 27, 2264
"/Users/phylliphall/Documents/Programs/esp/src/lib/server/dbGel/init/dbGelInit80ContentAITraining.ts", "TypeScript", 1923, 0, 11, 33, 1967
"/Users/phylliphall/Documents/Programs/esp/src/lib/server/dbGel/init/dbGelInit80ContentCrm.ts", "TypeScript", 186, 0, 3, 7, 196
"/Users/phylliphall/Documents/Programs/esp/src/lib/server/dbGel/init/dbGelInit80ContentCrmRep.ts", "TypeScript", 66, 0, 0, 4, 70
"/Users/phylliphall/Documents/Programs/esp/src/lib/server/dbGel/init/dbGelInit80ContentMOEDCm.ts", "TypeScript", 1816, 0, 86, 22, 1924
"/Users/phylliphall/Documents/Programs/esp/src/lib/server/dbGel/init/dbGelInit80ContentMOEDCmAdvocate.ts", "TypeScript", 308, 0, 21, 9, 338
"/Users/phylliphall/Documents/Programs/esp/src/lib/server/dbGel/init/dbGelInit80ContentMOEDRep.ts", "TypeScript", 2, 0, 0, 2, 4
"/Users/phylliphall/Documents/Programs/esp/src/lib/server/dbGel/init/dbGelInit80ContentMOEDSSR.ts", "TypeScript", 1121, 0, 15, 26, 1162
"/Users/phylliphall/Documents/Programs/esp/src/lib/server/dbGel/init/dbGelInit80ContentMigrPerson.ts", "TypeScript", 52, 0, 85, 3, 140
"/Users/phylliphall/Documents/Programs/esp/src/lib/server/dbGel/init/dbGelInit80ContentSys.ts", "TypeScript", 17, 0, 0, 3, 20
"/Users/phylliphall/Documents/Programs/esp/src/lib/server/dbGel/init/dbGelInit80contentCm.ts", "TypeScript", 186, 0, 1, 6, 193
"/Users/phylliphall/Documents/Programs/esp/src/lib/server/dbGel/init/types.init.ts", "TypeScript", 621, 0, 6, 54, 681
"/Users/phylliphall/Documents/Programs/esp/src/lib/server/env.ts", "TypeScript", 4, 0, 0, 2, 6
"/Users/phylliphall/Documents/Programs/esp/src/lib/utils/DataViewer.svelte", "Svelte", 0, 12, 0, 2, 14
"/Users/phylliphall/Documents/Programs/esp/src/lib/utils/types.token.ts", "TypeScript", 490, 0, 0, 40, 530
"/Users/phylliphall/Documents/Programs/esp/src/lib/utils/types.ts", "TypeScript", 8, 0, 1, 1, 10
"/Users/phylliphall/Documents/Programs/esp/src/lib/utils/types.user.svelte.ts", "TypeScript", 276, 0, 69, 29, 374
"/Users/phylliphall/Documents/Programs/esp/src/lib/utils/utils.appstore.ts", "TypeScript", 34, 0, 4, 5, 43
"/Users/phylliphall/Documents/Programs/esp/src/lib/utils/utils.array.ts", "TypeScript", 33, 0, 1, 5, 39
"/Users/phylliphall/Documents/Programs/esp/src/lib/utils/utils.date.ts", "TypeScript", 31, 0, 5, 4, 40
"/Users/phylliphall/Documents/Programs/esp/src/lib/utils/utils.debug.ts", "TypeScript", 12, 0, 0, 2, 14
"/Users/phylliphall/Documents/Programs/esp/src/lib/utils/utils.error.ts", "TypeScript", 25, 0, 1, 7, 33
"/Users/phylliphall/Documents/Programs/esp/src/lib/utils/utils.model.ts", "TypeScript", 204, 0, 2, 13, 219
"/Users/phylliphall/Documents/Programs/esp/src/lib/utils/utils.process.ts", "TypeScript", 35, 0, 0, 4, 39
"/Users/phylliphall/Documents/Programs/esp/src/lib/utils/utils.processMigrate.ts", "TypeScript", 24, 0, 0, 4, 28
"/Users/phylliphall/Documents/Programs/esp/src/lib/utils/utils.randomDataGenerator.ts", "TypeScript", 389, 0, 4, 31, 424
"/Users/phylliphall/Documents/Programs/esp/src/lib/utils/utils.report.ts", "TypeScript", 5, 0, 0, 1, 6
"/Users/phylliphall/Documents/Programs/esp/src/lib/utils/utils.sys.ts", "TypeScript", 156, 0, 9, 24, 189
"/Users/phylliphall/Documents/Programs/esp/src/lib/utils/utils.ts", "TypeScript", 8, 0, 0, 1, 9
"/Users/phylliphall/Documents/Programs/esp/src/routes/+error.svelte", "Svelte", 0, -12, 0, -3, -15
"/Users/phylliphall/Documents/Programs/esp/src/routes/+layout.svelte", "Svelte", 0, -16, 0, -5, -21
"/Users/phylliphall/Documents/Programs/esp/src/routes/+page.server.ts", "TypeScript", -18, 0, 0, -5, -23
"/Users/phylliphall/Documents/Programs/esp/src/routes/+page.svelte", "Svelte", 0, -113, 0, -8, -121
"/Users/phylliphall/Documents/Programs/esp/src/routes/admin/+page.svelte", "Svelte", 0, -15, 0, -3, -18
"/Users/phylliphall/Documents/Programs/esp/src/routes/admin/apiTest/+page.server.ts", "TypeScript", -3, 0, 0, -1, -4
"/Users/phylliphall/Documents/Programs/esp/src/routes/admin/apiTest/+page.svelte", "Svelte", 0, -12, -3, -7, -22
"/Users/phylliphall/Documents/Programs/esp/src/routes/admin/formBuilder/+page.server.ts", "TypeScript", -3, 0, 0, -1, -4
"/Users/phylliphall/Documents/Programs/esp/src/routes/admin/formBuilder/+page.svelte", "Svelte", 0, -34, -1, -12, -47
"/Users/phylliphall/Documents/Programs/esp/src/routes/admin/formBuilder/FormBuilderColumn.svelte", "Svelte", 0, -6, -1, -4, -11
"/Users/phylliphall/Documents/Programs/esp/src/routes/api/+server.ts", "TypeScript", -63, 0, 0, -19, -82
"/Users/phylliphall/Documents/Programs/esp/src/routes/api/api.ts", "TypeScript", -41, 0, 0, -5, -46
"/Users/phylliphall/Documents/Programs/esp/src/routes/api/apiTwilio.ts", "TypeScript", -37, 0, -1, -6, -44
"/Users/phylliphall/Documents/Programs/esp/src/routes/api/dbEdge/dbEdge.ts", "TypeScript", -73, 0, 0, -12, -85
"/Users/phylliphall/Documents/Programs/esp/src/routes/api/dbEdge/dbEdgeGetVal.ts", "TypeScript", -389, 0, -10, -43, -442
"/Users/phylliphall/Documents/Programs/esp/src/routes/api/dbEdge/dbEdgeProcess.ts", "TypeScript", -511, 0, -14, -57, -582
"/Users/phylliphall/Documents/Programs/esp/src/routes/api/dbEdge/dbEdgeProcessDynDO.ts", "TypeScript", -23, 0, 0, -5, -28
"/Users/phylliphall/Documents/Programs/esp/src/routes/api/dbEdge/dbEdgeProcessDynDOReportRender.ts", "TypeScript", -156, 0, 0, -17, -173
"/Users/phylliphall/Documents/Programs/esp/src/routes/api/dbEdge/dbEdgeQuery.ts", "TypeScript", -457, 0, -5, -52, -514
"/Users/phylliphall/Documents/Programs/esp/src/routes/api/dbEdge/dbEdgeScript.ts", "TypeScript", -529, 0, -10, -49, -588
"/Users/phylliphall/Documents/Programs/esp/src/routes/api/dbEdge/dbEdgeScriptTypes.ts", "TypeScript", -297, 0, -3, -19, -319
"/Users/phylliphall/Documents/Programs/esp/src/routes/api/dbEdge/dbEdgeUtilities.ts", "TypeScript", -719, 0, -1, -45, -765
"/Users/phylliphall/Documents/Programs/esp/src/routes/api/dbEdge/types.dbEdge.ts", "TypeScript", -3, 0, 0, -1, -4
"/Users/phylliphall/Documents/Programs/esp/src/routes/api/legalDisclosure/+server.ts", "TypeScript", -12, 0, 0, -4, -16
"/Users/phylliphall/Documents/Programs/esp/src/routes/api/quote/+server.ts", "TypeScript", -42, 0, -33, -7, -82
"/Users/phylliphall/Documents/Programs/esp/src/routes/api/vercel/+server.ts", "TypeScript", -40, 0, 0, -7, -47
"/Users/phylliphall/Documents/Programs/esp/src/routes/auth/[authType]/+page.server.ts", "TypeScript", -18, 0, 0, -5, -23
"/Users/phylliphall/Documents/Programs/esp/src/routes/auth/[authType]/+page.svelte", "Svelte", 0, -98, 0, -12, -110
"/Users/phylliphall/Documents/Programs/esp/src/routes/dev/+layout.svelte", "Svelte", 0, -1, 0, -1, -2
"/Users/phylliphall/Documents/Programs/esp/src/routes/dev/+page.svelte", "Svelte", 0, -3, 0, -2, -5
"/Users/phylliphall/Documents/Programs/esp/src/routes/home/+layout.server.ts", "TypeScript", -5, 0, -1, -2, -8
"/Users/phylliphall/Documents/Programs/esp/src/routes/home/+layout.svelte", "Svelte", 0, -77, 0, -11, -88
"/Users/phylliphall/Documents/Programs/esp/src/routes/home/+page.server.ts", "TypeScript", -3, 0, -2, -1, -6
"/Users/phylliphall/Documents/Programs/esp/src/routes/home/+page.svelte", "Svelte", 0, -3, 0, -1, -4
"/Users/phylliphall/Documents/Programs/esp/src/routes/home/Quote.svelte", "Svelte", 0, -36, 0, -5, -41
"/Users/phylliphall/Documents/Programs/esp/src/routes/home/User.svelte", "Svelte", 0, -11, 0, -2, -13
"/Users/phylliphall/Documents/Programs/esp/src/routes/home/UserCM.svelte", "Svelte", 0, -20, -3, -2, -25
"/Users/phylliphall/Documents/Programs/esp/src/routes/home/account/+page.server.ts", "TypeScript", -2, 0, -4, -1, -7
"/Users/phylliphall/Documents/Programs/esp/src/routes/home/account/+page.svelte", "Svelte", 0, -1, 0, -1, -2
"/Users/phylliphall/Documents/Programs/esp/src/routes/home/app/+page.svelte", "Svelte", 0, -3, 0, -1, -4
"/Users/phylliphall/Documents/Programs/esp/src/routes/home/cm/activities/+page.svelte", "Svelte", 0, -6, 0, -2, -8
"/Users/phylliphall/Documents/Programs/esp/src/routes/home/cm/application/+page.server.ts", "TypeScript", -14, 0, 0, -3, -17
"/Users/phylliphall/Documents/Programs/esp/src/routes/home/cm/application/+page.svelte", "Svelte", 0, -57, -24, -11, -92
"/Users/phylliphall/Documents/Programs/esp/src/routes/home/cm/application/+server.ts", "TypeScript", -18, 0, 0, -4, -22
"/Users/phylliphall/Documents/Programs/esp/src/routes/home/cm/docs/+server.ts", "TypeScript", -9, 0, -27, -7, -43
"/Users/phylliphall/Documents/Programs/esp/src/routes/home/cm/docs/ElgDocRec.svelte", "Svelte", 0, -82, -6, -16, -104
"/Users/phylliphall/Documents/Programs/esp/src/routes/home/cm/docs/ElgDocsList.svelte", "Svelte", 0, -84, 0, -14, -98
"/Users/phylliphall/Documents/Programs/esp/src/routes/home/cm/example/+page.server.ts", "TypeScript", -3, 0, 0, -1, -4
"/Users/phylliphall/Documents/Programs/esp/src/routes/home/cm/example/+page.svelte", "Svelte", 0, -7, -9, -5, -21
"/Users/phylliphall/Documents/Programs/esp/src/routes/home/cm/example/+server.ts", "TypeScript", -6, 0, 0, -3, -9
"/Users/phylliphall/Documents/Programs/esp/src/routes/home/cm/goals/+page.svelte", "Svelte", 0, -7, 0, -2, -9
"/Users/phylliphall/Documents/Programs/esp/src/routes/home/cm/messages/+page.svelte", "Svelte", 0, -6, 0, -2, -8
"/Users/phylliphall/Documents/Programs/esp/src/routes/home/cm/quotes/+page.svelte", "Svelte", 0, -6, 0, -2, -8
"/Users/phylliphall/Documents/Programs/esp/src/routes/legalDisclosure/+page.server.ts", "TypeScript", -3, 0, -2, -1, -6
"/Users/phylliphall/Documents/Programs/esp/src/routes/legalDisclosure/+page.svelte", "Svelte", 0, -60, 0, -9, -69
"Total", "-", 36804, 2818, 626, 1680, 41928